1111111111111111111111111111111111111111111111111
1111111111111111111111111111111111111111111111111
1000000000000000000000000000000000000000000000001
1000000000000000000000000000000000000000000000001
1000000000000000000000000000000000000000000000001
1000000011111100000000001000000000011111100000001
1000000011111100000000000000000000011111100000001
1000000011100000000000000000000000000011100000001
1000000011100000000000000000000000000011100000001
1000000011100000000000000000000000000011100000001
1000000011100000000000222000000000000011100000001
1000000011100000000000000000000000000011100000001
1000000011100000000000000000000000000011100000001
1000000011100000000000000000000000000011100000001
1000000011100000000000000000000000000011100000001
1000000011100000000000000000000000000011100000001
1000000011111100000000000000000000011111100000001
1000000011111100000000001000000000011111100000001
1000000000000000000000000000000000000000000000001
1000000000000000000000000000000000000000000000001
1000000000000000000000000000000000000000000000001
1111111111111111111111111111111111111111111111111
1111111111111111111111111111111111111111111111111