1111111111111111111111111111111111111111111111111
1111111111111111111111111111111111111111111111111
1000000000000000000000000000000000000000000000001
1000000000000000000000000000000000000000000000001
1000000000000000000000000000000000000000000000001
1111111111111100000000001000000000011111111111111
        111111000000000000000000000111111        
        111000000000000000000000000000111        
        111000000000000000000000000000111        
        111000000000000000000000000000111        
        111000000000002220000000000000111        
        111000000000000000000000000000111        
        111000000000000000000000000000111        
        111000000000000000000000000000111        
        111000000000000000000000000000111        
        111000000000000000000000000000111        
        111111000000000000000000000111111        
1111111111111100000000001000000000011111111111111
1000000000000000000000000000000000000000000000001
1000000000000000000000000000000000000000000000001
1000000000000000000000000000000000000000000000001
1111111111111111111111111111111111111111111111111
1111111111111111111111111111111111111111111111111